CA_BOOKING_ID	int
CI_BORR_ID	int
CI_UNIT_ID	int
GE_ORG_ID	int
GE_ORG_ID_ACCOUNT	int
GE_ORG_ID_RESPONSIBLE	varchar	256
CA_CATALOG_ID	int
CA_CATCH_FIRST_RES_ID	varchar	256
CA_COPY_ID	int
CA_COPY_ID_CAUGHT	varchar	256
CI_UNIT_ID_CAUGHT_AT	varchar	256
IL_LOAN_ID	int
SY_USER_ID_CREATE	varchar	256
CREATE_DATETIME	datetime
SY_USER_ID_MODIFY	varchar	256
MODIFY_DATETIME	datetime
VALID_FROM_DATE	date
VALID_TO_DATE	date
REMARK_ON_BOOKING	varchar	1024
BOOKING_DATETIME	datetime
CAUGHT_DATETIME	datetime
CAUGHT_EXPIRE_DATE	datetime
GLOBAL_BOOKING	int
SHELF_BOOKING	int
FORCED_BOOKING	int
CA_SERIAL_BOOKING_ID	int
SERIAL_BOOKING_ORDER	int
BOOKING_ORDER	int
SEQ_NO	int
ORIG_GE_ORG_ID	int
