CA_COPY_ID	int
CA_CATALOG_ID	int
AC_SUPPLIER_ID	int
CA_LOC_ID	int
CA_NOT_AVAILABLE_CAUSE_ID	int
CI_CAT_ID	int
CI_UNIT_ID	int
CI_UNIT_ID_LATEST_CAUGHT_AT	int
GE_PREMISES_ID	int
ORIG_CA_LOC_ID	int
ORIG_CI_CAT_ID	int
ORIG_GE_PREMISES_ID	int
LATEST_LOCATION_DATE	date
OLD_NO_OF_LOAN	int
SY_USER_ID_CREATE	varchar	256
CREATE_DATETIME	datetime
SY_USER_ID_MODIFY	varchar	256
MODIFY_DATETIME	datetime
DEVIATING_LOANTIME	varchar	256
DEVIATING_LOCATION_MARC	varchar	256
FIRST_LOCATION_DATE	date
LATEST_CAUGHT_DATETIME	datetime
NOTE	varchar	1024
ORIG_DEVIATING_LOANTIME	varchar	256
ORIG_DEVIATING_LOCATION_MARC	varchar	256
PURCHASE_PRICE	varchar	256
PUBLISH_NO	varchar	256
TEMP_LOC_VALID_TO	varchar	256
NO_OF_LOAN_CURR_YEAR	int
LATEST_LOAN_DATETIME	datetime
CI_UNIT_ID_LATEST_BORROWED_AT	int
CA_COPY_TYPE_ID	int
GE_ORG_ID_ACCOUNT	int
GE_ORG_ID_UNIT	int
NOT_AVAIL_MODIFY_DATETIME	datetime
TEMP_LOC_VALID_FROM	date
NEW_MEDIA	int
CA_LOCATION_TYPE_ID	int
FLOATING_VALID_TO	int
ORIG_GE_ORG_ID_ACCOUNT	int
ORIG_GE_ORG_ID_UNIT	int
EXT_NOTE	varchar	1024
DELETED	int
