CI_BORR_ID	int
CI_BORR_CAT_ID	int
GE_ORG_ID	int
CI_BORR_ADDR_ID	int
CI_BORR_GRP_ID	int
CI_BORR_EXTRA_1_ID	int
CI_BORR_EXTRA_2_ID	int
OLD_NO_OF_LOAN	int
SY_USER_ID_CREATE	int
CREATE_DATETIME	datetime
SY_USER_ID_MODIFY	int
MODIFY_DATETIME	datetime
VALID_TO_DATE	date
NO_OF_LOAN_CURR_YEAR	int
LATEST_LOAN_DATETIME	datetime
EXTRA_ELIGIBILITY	bool
ABSENT_FROM_DATE	date
ABSENT_TO_DATE	date
DEF_PICKUP_PLACE	varchar	256
GE_ORG_ID_UNIT	int
CI_CLASS_ID	int
