CI_BORR_EVENT_ID	int
SY_CI_EVENT_TYPE_ID	varchar	32
GE_ORG_ID_OWNER	varchar	256
EVENT_DATETIME	datetime
CI_UNIT_ID	int
CA_CATALOG_ID	int
CI_BORR_ID	int
CI_BORR_EXTRA_1_CODE	varchar	32
CI_BORR_EXTRA_2_CODE	varchar	32
CI_LOAN_ID	int
GE_ORG_ID	int
LATEST_EVENT_TYPE	varchar	32
LATEST_EVENT_DATETIME	datetime
REMOVED	varchar	256
REMOVED_DATETIME	datetime
CI_UNIT_ID_REMOVED	varchar	256
CI_BORR_CAT_ID	int
CI_BORR_GRP_ID	int
DATE_OF_BIRTH	date
POST_CODE	varchar	256
REMOVED_ELG_DATETIME	datetime
GE_ORG_ID_CLASS	varchar	256
CI_CLASS_ID	int
