CI_DEBT_ID	int
CI_BORR_ID	int
CI_UNIT_ID	int
GE_ORG_ID	int
SY_CI_PARAM_ID	varchar	32
CA_BOOKING_ID	int
CA_CATCH_FIRST_RES_ID	int
CI_DEBT_ID_PARENT	int
CI_REM_MSG_ID	int
CI_RENEWAL_ID	int
SY_USER_ID_CREATE	varchar	256
CREATE_DATETIME	datetime
SY_USER_ID_MODIFY	varchar	256
MODIFY_DATETIME	datetime
AMOUNT	int
MAX_AMOUNT	int
NOTE	varchar	1024
CA_COPY_ID	int
LOAN_DATETIME	datetime
DUE_DATETIME	datetime
RETURN_DATETIME	datetime
