CA_COPY_ID	int
CI_LOAN_ID	int
CI_UNIT_ID	int
CA_BOOKING_ID	int
CI_BORR_ID	int
GE_ORG_ID	int
CI_BORR_CARD_ID	varchar	256
CI_UNIT_ID_RETURN	int
SY_SEX_ID	int
LOAN_DATETIME	datetime
DUE_DATETIME	datetime
SY_USER_ID_CREATE	varchar	256
CREATE_DATETIME	datetime
SY_USER_ID_MODIFY	varchar	256
MODIFY_DATETIME	datetime
BORR_AGE	int
RETURN_DATETIME	datetime
OVERDUE_WARNING_DATETIME	datetime
GE_ORG_ID_UNIT	int
OPEN_LOANTIME	varchar	256
E_MEDIA_PROVIDER_FORMAT_ID	int
E_MEDIA_PROVIDER_NAME	varchar	256
