CI_UNIT_ID	int
GE_ORG_ID	int
SY_ALERT_TYPE_ID	int
SY_GE_MSG_FORM_ID	int
SY_GE_MSG_FORM_ID_RENEWAL	int
SY_GE_MSG_FORM_ID_RETURN	int
NAME	varchar	256
DESCR	varchar	256
AUTO_RECEIPT_BOOKING	int
AUTO_RECEIPT_LOAN	int
AUTO_RECEIPT_RENEWAL	int
AUTO_RECEIPT_RETURN	int
TIME_UNIT_LOAN	int
TIME_UNIT_RENEWAL	int
SY_USER_ID_CREATE	varchar	256
CREATE_DATETIME	datetime
SY_USER_ID_MODIFY	varchar	256
MODIFY_DATETIME	datetime
PHOTOCOPY_HAND_OUT	int
GE_PHOTOCOPY_TYPE_ID	int
YEARSTAT_CAT	int
AUTO_RECEIPT_DEPT_PAYMENT	int
FINAL_CAUGHT_UNIT	int
AUTO_RECEIPT_EMAIL	int
