IL_LOAN_ID	int
GE_ORG_ID_BELONG_TO	int
GE_ORG_ID_COLLECT_AT	int
IL_STATUS_ID	int
CA_CATALOG_ID	varchar	32
CA_COPY_ID	int
CI_BORR_ID	int
GE_ORG_ID_DELIVER_TO	int
IL_LIBRARY_ID	int
IL_LIBRARY_ID_REQUEST_TO	int
IL_LIBRARY_ID_RETURN_TO	int
SY_USER_ID_CREATE	varchar	32
CREATE_DATETIME	datetime
SY_USER_ID_MODIFY	varchar	32
MODIFY_DATETIME	datetime
ORDER_DATE	datetime
ORDER_REG_BY	varchar	32
ARRIVAL_REG	varchar	32
ARRIVAL_DATE	date
ARRIVAL_REG_BY	varchar	32
RETURN_DATE	date
RETURN_REG_BY	varchar	32
COMPLETE_DATE	date
COMPLETE_REG_BY	varchar	32
ON_LINE_ORDER	boolean
COST	int
DUE_DATE	date
LATEST_RETURN_DATE	date
VALID_TO_DATE	date
IL_LIBRARY_LABEL	varchar	256
CANCELLED_DATE	date
CANCELLED_REG_BY	varchar	32
COPIES_FOR_FREE	int
GE_ORG_ID	int
REFERENCE	varchar	256
RENEWAL_REQUEST_DATE	date
RENEWAL_REQUEST_REG_BY	varchar	32
REMARK	varchar	1024
ARTICLE	varchar	1024
REMINDER_DATE	date
EXT_IL_LOAN_ID	int
EXT_DESCR	varchar	1024
REMINDER_REG_BY	varchar	32
