PE_SUBSCRIPTION_ID	int
CA_LOC_ID	int
GE_PREMISES_ID	int
PE_TITLE_ID	int
AC_ACCOUNT_ID	int
CI_CAT_ID	int
ARRIVAL_REG	varchar	32
LOC_REG	varchar	32
VALID_FROM_DATE	date
SY_USER_ID_CREATE	int
SY_USER_ID_MODIFY	int
MODIFY_DATETIME	datetime
CREATE_DATETIME	datetime
VALID_TO_DATE	date
DEVIATING_LOANTIME	varchar	256
DEVIATING_LOCATION_MARC	varchar	256
LATEST_ORDERDATE	date
NEXT_ORDERDATE	date
REMARK	varchar	1024
SUBSCRIPTION_NUMBER	int
CANCELLED	bool
CANCELLED_DATE	date
GE_ORG_ID_ACCOUNT	int
GE_ORG_ID_UNIT	int
PE_HANDLE_TYPE_ID	int
EXTERNAL	bool
REMARK_TO_SUPPLIER	varchar	1024
NO_AVAIL_DIRECT	bool
NO_AVAIL_IN_STACKS	bool
EXPECTANCY	varchar	32
EXPECTANCY_NOTE	varchar	1024
CI_CAT_PREV_ID	int
PE_CIRC_RULE_ID	int
NOTE	varchar	1024
EXT_NOTE	varchar	1024
