SY_USER_ID	int
CA_GENERIC_FORM_ID	int
CA_MEDIA_TYPE_ID	int
CI_UNIT_ID	int
LA_LANGUAGE_ID	int
SY_ROLE_ID	int
FIRST_NAME	varchar	256
SURNAME	varchar	256
NO_OF_DAYS_PW_CHANGE	int
PW_CHANGED_DATE	date
SY_USER_ID_CREATE	datetime
CREATE_DATETIME	datetime
SY_USER_ID_MODIFY	datetime
MODIFY_DATETIME	datetime
PHONE	varchar	32
FAX	varchar	32
EMAIL_ADDR	varchar	256
CATEGORY	int
PUBLICATION_CODE	int
LANG	int
LOGIN	int
HIT_SORT	boolean
SHOW_QUERY	boolean
LOGO_IMAGE	varchar	256
LOGO_URL	varchar	256
EXTERNAL_URL	varchar	256
ONE_TIME_PASSWORD	varchar	256
OPAC_DEF_PICKUP_PLACE	varchar	256
OPAC_TITLE_GENERIC_FORM_ID	int
GE_ORG_ID_ACCOUNT	int
GE_ORG_ID_UNIT	int
OPAC_SHOW_MAP	boolean
PERMIT_OVERDUE_WARNING	boolean
PERMIT_SMS_SERVICE	boolean
OPAC_MAP_URL	varchar	256
PASSWORD	varchar	256
USER_BLOCKED	boolean
LOGIN_ATTEMPTS	int
GE_ORG_GROUP_ID	int
USE_BORR_PICKUP	boolean
ALMA_CRD_SHOW_ORG	boolean
GET_FACET_AUTHOR	boolean
GET_FACET_LANGUAGE	boolean
GET_FACET_LOC_MARC	boolean
GET_FACET_MEDIA_TYPE	boolean
GET_FACET_PUBL_YEAR	boolean
GET_EXT_SEARCH_SUGGESTION	boolean
GET_INT_SEARCH_SUGGESTION	boolean
CHOOSE_UNIT	boolean
LATEST_LOGIN_DATETIME	datetime
VISIBLE	boolean
SUPERUSER	boolean
FONT_SIZE	varchar	16
FONT_FOR_CATALOG	varchar	32
FONT_FOR_CLIENT	varchar	32
SHOW_ON_WAY_NEW_AS_IN	boolean
USE_FUZZY_PATRON_SEARCH	boolean
SORT_ID_CCL_HITLIST	boolean
START_WINDOW_WIDTH	int
START_WINDOW_HEIGHT	int
FUZZY_ZERO_HITS_CCL	int
USE_2FA	bit
ALMA_SHOW_LOAN_OTHER_ORGS	bit
GET_FACET_PUBL_TYPE	bit
GET_FACET_AGE_GRP	bit
