ItemId	int
OrderId	int
ExternalOrderLineNo	int
ExternalProductId	nvarchar
Price	decimal
DeliveryDate	datetime2
Id	int
OrderLineStatusId	int
AccountCode	nvarchar
CurrencyId	int
Title	nvarchar
ItemControlNumber	nvarchar
Author	nvarchar
ReminderCount	int
ReceivedTime	datetime2
Notes	nvarchar
ModBy	nvarchar
ModTime	datetime2
RegBy	nvarchar
RegTime	datetime2
LockedBy	nvarchar
AccountPeriodId	int
LastReminderTime	datetime2
