Id	int
MarcRecordId	int
Barcode	nvarchar
ItemNo	int
ItemName	nvarchar
Shelf	nvarchar
ItemStatus	int
ControllingUnitId	int
BelongToUnitId	int
PlacedAtUnitId	int
ILLUnitId	int
RegBy	nvarchar
RegTime	datetime2
ModBy	nvarchar
ModTime	datetime2
StatusChangedBy	nvarchar
StatusChangedTime	datetime2
ScrapDate	datetime2
PermitLoan	bit
ShowInOpac	bit
LoanCountStarted	datetime2
LoanCount	int
RenewalCount	int
BoxNo	smallint
Retrospective	bit
Notes	nvarchar
CategoryNewCheckedIn	date
LoanTypeId	int
CulturalFundBook	bit
IsMagneticMedia	bit
ItemBindingText	nvarchar
LastLentToBorrowerDate	datetime2
Location	int
IsPicked	bit
AllowILL	bit
AllowLII	bit
IsFloating	bit
OnCart	bit
CompensationPrice	int
