Id	int
RootMarcId	int
ScrapDate	datetime2
RegBy	nvarchar
RegTime	datetime2
ModBy	nvarchar
ModTime	datetime2
DocumentGroupId	int
MaterialTypeId	int
WorkTitle	nvarchar
WorkAuthor	nvarchar
PublYear	nvarchar
ISBN	nvarchar
ImportSessionId	int
Level	int
HasChildren	bit
IsSerial	bit
EAN	nvarchar
ISSN	nvarchar
ISRN	nvarchar
SICI	nvarchar
IntellectualLevel	nchar
FictionCode	nchar
LeftLink	int
RightLink	int
TemplateId	int
TrackedFieldsChangedByImport	bit
UpdatedByImportTime	datetime
ApprovedAfterImport	bit
