Id	int
BorrowerId	int
MarcRecordId	int
LocalUnitId	int
ItemId	int
AccountCodeId	int
AccountDate	datetime2
Amount	numeric
RegBy	nvarchar
DueTime	datetime2
QTY	int
ItemPrice	numeric
Payment	numeric
Released	smallint
ModDate	datetime2
Notes	nvarchar
MM2_Account_Id	int
CompensationSequenceNumber	int
ModBy	nvarchar
ModTime	datetime2
