Id	int
ILLStatusId	int
ItemId	int
BorrowerId	int
LibraryId	int
OrderingUnitId	int
DeliverAtUnitId	int
LibraryDueDate	datetime2
BorrowerDueDate	datetime2
IsCopyLoan	smallint
IsElectronicCopy	smallint
ServiceId	int
Notes	nvarchar
OwnerReference	nvarchar
OrderedDate	datetime2
ReceivedDate	datetime2
ReturnedDate	datetime2
RegTime	datetime2
RegBy	nvarchar
ModTime	datetime2
ModBy	nvarchar
FlagRead	smallint
ReminderCount	int
IsLII	smallint
RequestId	nvarchar
OwnerItemBarCode	nvarchar
OwnerLocalRecordId	nvarchar
ItemIdentificatorType	nvarchar
