Id	int
ResType	int
DocumentGroupId	int
BorrowerId	int
ServiceCode	int
MarcRecordId	int
ItemId	int
NumRecalls	smallint
ResPriority	smallint
ResTitle	smallint
ResTime	datetime2
ResActivationTime	datetime2
ResValidUntil	date
DueTime	datetime2
NextRecallTime	datetime2
ServiceTime	datetime2
PrevResId	int
ResHeldUntil	datetime2
Notes	nvarchar
DeliverAtLocalUnitId	int
ReserveAtLocalUnitId	int
ServiceAtLocalUnitId	int
ModBy	nvarchar
ResTitleAllItems	smallint
ReservationScope	varchar
MM2_Service_Id	int
ReminderSent	smallint
ReservationNumber	nvarchar
ReservationNote	nvarchar
ReservationNote` varchar(1024),
ResInactiveUntil	datetime
ResPausedFrom	datetime
ResPausedTo	datetime
ResActiveToday	bit
LastMessageMedium	varchar
