ServiceId	int
Id	int
MarcRecordId	int
ItemId	int
ServiceCode	int
ServiceTime	datetime2
ServiceCost	float
RecallNum	smallint
ResType	smallint
ResActivationTime	datetime2
CryptBorrowerId	int
UserId	nvarchar
BorrowerId	int
MM2_Service_Id	int
ServiceAtUnitId	int
DueTime	datetime2
BorrowerGroupId	int
LiteraryForm	nchar
IntellectualLevel	nchar
Sex	nchar
YearOfBirth	nvarchar
ZipCode	nvarchar
MaterialLanguage	nvarchar
MaterialTypeId	int
DocumentGroupId	int
BorrowerHomeUnitId	int
BelongToUnitId	int
PlacedAtUnitId	int
ClassId	int
ClassName	nvarchar
GeographicalNo	nvarchar
CulturalFundBook	smallint
LoanTypeName	nvarchar
IntellectualLevelGroup	nchar
LiteraryFormGroup	nchar
ReservationNumber	nvarchar
ServiceSourceId	int
ControllingUnitId	int
