Id	int
LocalUnitId	int
MaterialTypeId	int
BorrowerGroupId	int
PermitLoan	smallint
ReservationHeldDays	int
LoanPeriod	int
RenewPeriod	int
MaxLoans	int
MaxReservations	int
MaxRenewals	int
Recl1Delay	int
Recl2Delay	int
Recl3Delay	int
Recl4Delay	int
StopDelay	int
PriceReservation	float
PriceLoan	float
PriceRenew	float
PriceRecall1	float
PriceRecall2	float
PriceRecall3	float
PriceRecall4	float
PriceCompensation	float
NumRecalls	smallint
StopOnMaxRenewals	smallint
PriceNotify	float
FineOverdue	float
Notes	nvarchar
FineOverduePerDay	float
GracePeriod	int
RenewFromDueDate	smallint
ResNoOfDays	int
ModDate	datetime2
MM2_Ter_Id	int
ModBy	nvarchar
UsesUnit	smallint
UsesLoanType	smallint
UsesBorrowerGroups	smallint
UsesDocumentGroups	smallint
UsesMarcField	smallint
Weight	nvarchar
Name	nvarchar
LimitLoanTimeIfQueue	smallint
QueueThreshold	int
LoanTimeLimit	int
PermitReservations	smallint
UseANDOnMarcFields	smallint
FixedReturnDate	datetime2
IsILLTerm	smallint
ExcludeClosedDays	bit
MaxOverdueDayFees	float
OverridesTermId	int
OverrideFromDate	date
OverrideToDate	date
OverrideActive	bit
FixedRenewalDate	datetime2
IsTemporaryBorrowersTerm	bit
