Id	int
Name	nvarchar
AdministratorName	nvarchar
LastUpdated	datetime2
MM2_Loaner_Group_Id	int
Expires	date
ExpirePeriodDays	int
ExpireType	smallint
DefResPriority	smallint
Notes	nvarchar
MoveAge	smallint
MoveToId	int
OverrideGlobalFines	smallint
Recall2Price	float
Recall3Price	float
Recall4Price	float
CompensationPrice	float
NotifyPrice	float
Recall1Price	float
Homebound	smallint
AllowDuplicateRes	smallint
DoBeep	smallint
SoundId	int
AdministratorId	int
IsDefaultGroup	smallint
Description	nvarchar
CompensationLetterFine	float
UseItemPrice	smallint
ReminderLetterPrice	float
ReminderEmailPrice	float
ReminderSMSPrice	float
NotifyEmailPrice	float
NotifySMSPrice	float
FirstRecallEmailPrice	float
FirstRecallSMSPrice	float
SecondRecallEmailPrice	float
SecondRecallSMSPrice	float
ThirdRecallEmailPrice	float
ThirdRecallSMSPrice	float
FourthRecallEmailPrice	float
FourthRecallSMSPrice	float
CompensationEmailPrice	float
CompensationSMSPrice	float
IsActive	smallint
IsInstitution	smallint
OverrideILLPrices	smallint
ILLCopyPrice	float
ILLLoanPrice	float
IsLIIGroup	smallint
SysName	nvarchar
IsProtected	smallint
IsExternalLibraries	smallint
MaxOverdueFeePerBorrowerPerDay	float
LateFeeLimitForDefaulting	float
IsDelivery	bit
IsDefaultNewBorrowerWeb	bit
BibPlussIsDefault	bit
BorrowerCanHaveParents	bit
RestrictParentAccessAtAge	int
SeverConnectionToParentsAtAge	int
IsTemporaryBorrowersGroup	bit
RequiresParent	bit
CascadeDefaultingToParent	bit
AutoDefaultMode	bit
TotalDebtLimitForDefaulting	int
