Id	int
BirthDate	date
Sex	nchar
HomeUnit	int
Expires	date
Defaulted	bit
DefaultedDate	date
DefaultedCauseId	int
BorrowerGroupId	int
PersonSSN	nvarchar
MessageToBorrower	nvarchar
MM2_Per_Id	int
Picture	varbinary
LastAct	date
DateEntered	date
Department	nvarchar
RegBy	nvarchar
RegDate	date
ModBy	nvarchar
ModDate	date
Extra1	nvarchar
Extra2	nvarchar
Extra3	nvarchar
Extra4	nvarchar
Extra5	nvarchar
LettersByEmail	bit
LoanActivity	int
Mobile	nvarchar
LettersBySMS	bit
GeographicalNo	nvarchar
LocalKey	nvarchar
ClassId	int
PreferredLanguage	nvarchar
RefuseReminderMessages	bit
AcceptSMSRecalls	bit
PostCount	int
Nick	nvarchar
AllowPosts	bit
AllowComments	bit
NationalBorrowerCardRemoved	nvarchar
IsILLDummy	bit
Homebound	bit
AutoMovedRecently	bit
HasBibPluss	bit
BibPlussAgreementBy	varchar
BibPlussAgreementDate	date
SendMessagesToBothParents	bit
ReceiptMessageFormat	int
HasReadInformationMessage	bit
