Id	int
Name	nvarchar
LastUpdated	datetime2
BarCode	nvarchar
MainAddrLine1	nvarchar
MainAddrLine2	nvarchar
MainZip	nvarchar
MainPlace	nvarchar
MainCountry	nvarchar
MainPhone	nvarchar
MainEmail	nvarchar
SecondAddrLine1	nvarchar
SecondAddrLine2	nvarchar
SecondZip	nvarchar
SecondPlace	nvarchar
SecondCountry	nvarchar
SecondFrom	date
SecondTo	date
SecondPhone	nvarchar
SecondEmail	nvarchar
Fax	nvarchar
URL	nvarchar
Password	binary
PinCode	nvarchar
Notes	nvarchar
LoanReceipt	int
ReturnReceipt	int
NotifyReceipt	int
SecondNotes	nvarchar
IsMortensBaby	smallint
ContactStatusId	int
ExternalSyncActive	bit
MainAddrLine3	nvarchar
SecondAddrLine3	nvarchar
DeprecatedPassword	nvarchar
