Id	int
LibrarySystem	nvarchar
LibraryNumber	nvarchar
DepartmentName	nvarchar
OtherName	nvarchar
LastCorrected	datetime2
Code	nvarchar
CountryNameEng	nvarchar
OtherNames	nvarchar
Reservations	nvarchar
AuthorizationCode	nvarchar
Unavailable	smallint
EmailILLAuto	nvarchar
EmailILLReceipt	nvarchar
Z3950Port	nvarchar
Z3950BaseName	nvarchar
Z3950ServerAddress	nvarchar
LibraryNumberOld	int
LibraryNoOverride	int
Manager	nvarchar
ManagerDeputy	nvarchar
ILLServices	int
CustomerTypeCode	nvarchar
URLOpac	nvarchar
NameEnglish	nvarchar
ILLContactPerson	nvarchar
URLZ3950Info	nvarchar
QuickCode	nvarchar
IsLocalRecord	smallint
LoanDuration	int
EmailXML	nvarchar
EmailXMLReceipt	nvarchar
BSName	nvarchar
Z3950UserName	nvarchar
Z3950UserPassword	nvarchar
Z3950Syntax	nvarchar
Z3950SkipMarcFields	nvarchar
Z3950DupControl	nvarchar
Z3950PreProcess	nvarchar
Z3950Ccl2Rpn	nvarchar
RemoteDeliveryWebserviceURL	nvarchar
OrgNo	nvarchar
URLNCIP	nvarchar
