Id	int
ParentUnitId	int
BankAccount	nvarchar
IsDepartment	smallint
SpeedCode	nvarchar
ExternalUnitName	nvarchar
AuthorizationCode	nvarchar
PasswordUnit	nvarchar
ServiceURL	nvarchar
MM2_Unit_Id	int
LicenceOwner	nvarchar
LicenceNextAutoUpgrade	date
IsILLUnit	smallint
IsVirtualUnit	smallint
IsActive	smallint
LibraryTypeId	int
UseNationalBorrowerCard	smallint
SaveBorrowerSSN	smallint
NewBorrowersUseNationalBorrowerCard	smallint
ExternalCode	nvarchar
ExternalAffiliateNumber	nvarchar
BibSvcAgreementId	int
RemoteDeliveryWebserviceURL	nvarchar
HolidayInfoFromDate	date
HolidayInfoToDate	date
DisplayHolidayInfo	bit
